R 1280 720
NO ./textures/wood.xpm
EA ./textures/wood.xpm
SO ./textures/cat.xpm
WE ./textures/cat.xpm
S ./textures/sprite.xpm
F 255,0,0
C 50,168,166

111111111111111111111111111111
111111000111111110000111011001
111111110000000000N20000011001
1100110001111101000 00011011111
120001011001100010111110011111
102200000001102010100011001001
1000010110011111100010111000001
110011011110001110100011001001
111111011111101110111111011111
111110001110001110111111010011
111111100010110000000000011111
111110001000000001110111011111
111111111111110001000010011111
111111111111111111111111111111