R 1280 720
NO ./textures/wood.xpm
EA ./textures/diamond.xpm
SO ./textures/wood.xpm
WE ./textures/brick.xpm
S ./pathSP.xpm
F 220,100,0
C 50,168,166

111111111111111111111111111111
111111000111111110000111011001
1111111100000000000N0000011001
110011000111110100000011011111
100001011001100010111110011111
100000000001100010100011001001
1000010110011111100010111000001
110011011110001110100011001001
111111011111101110111111011111
111110001110001110111111010011
111111100010110000000000011111
111110001000000001110111011111
111111111111110001000010011111
111111111111111111111111111111