11111
1000111111
1000000001
1000111111
11111

R 640 480
