R 1920 720
NO ./pathNO.xpm
EA ./pathEA.xpm
SO ./pathSO.xpm
WE ./pathWE.xpm
S ./pathSP.xpm

1111111111111111111111111
1000000000110000000000001
1011000001110000002000001
10010000000000000N0000001
1111111110110000011100001
         1  11111   1111